11111111111111111111111111111111
1.....M.....M.....M.....M.....M1
1..............................1
1..............................1
1..............................1
1..............................1
1..............................1
1..............................1
1..............................1
1..............................1
1..............................1
1...............................G
1...............................G
1...............................G
1..............................1
1..............................1
1..............................1
1..............................1
1..............................1
1..............................1
1.G............................1
1..............................1
1..............................1
11111111111111111111111111111111
